target=vram_tilemap
status=max_hits
watch_id=nil
hits=64
range=06001800-06002000
pcs:
000002A0 64
addresses:
06001B00 1
06001B02 1
06001B04 1
06001B06 1
06001B08 1
06001B0A 1
06001B0C 1
06001B0E 1
06001B10 1
06001B12 1
06001B14 1
06001B16 1
06001B18 1
06001B1A 1
06001B1C 1
06001B1E 1
06001B20 1
06001B22 1
06001B24 1
06001B26 1
06001B28 1
06001B2A 1
06001B2C 1
06001B2E 1
06001B30 1
06001B32 1
06001B34 1
06001B36 1
06001B38 1
06001B3A 1
06001B40 1
06001B42 1
06001B44 1
06001B46 1
06001B48 1
06001B4A 1
06001B4C 1
06001B4E 1
06001B50 1
06001B52 1
06001B54 1
06001B56 1
06001B58 1
06001B5A 1
06001B5C 1
06001B5E 1
06001B60 1
06001B62 1
06001B64 1
06001B66 1
06001B68 1
06001B6A 1
06001B6C 1
06001B6E 1
06001B70 1
06001B72 1
06001B74 1
06001B76 1
06001B78 1
06001B7A 1
06001B80 1
06001B82 1
06001B84 1
06001B86 1
